_ _ _ _ _ _ _ _ _ _ _ _ _ _ _ _ _ _
# # # # # # # # # # # # # # # # # #
# . . . . , . . . . . , , . . . . # 
# . . . . , . . . . . , , . . . . # 
L . . . . , . . . . . , , . . . . R 
# . . . . , . . . . . , , . . . . # 
# _ _ _ _ , _ _ _ _ _ , , _ _ _ _ # 
# # # # # # # # # # # # # # # # # #