_ _ _ _ / _ _ _ _
# # # # U # # # #
# . . . . . . . #
# . . . . . . . #
# . . . . . . . #
L . . . @ . . . R
# . . . . . . . #
# . . . . . . . #
# _ _ _ . _ _ _ #
# # # # D # # # #