_ _ _ _ _ _ _ _ _
# # # # # # # # #
# . . . @ . . . #
# . b b p b b . #
# . b . . . b . #
# . b . . . b . #
# . ^ . & . = . #
# . . . . . . . #
# _ _ _ _ _ _ _ #
# # # # # # # # #