_ _ _ _ _ _ _ _ _ _ _
# # # # # # # # # # #
# . . . . . # . . . #
# . . p b b D . * . #
# . . . . . # _ _ _ #
# . . . . . # # # # #
# . @ . . . . . . . #
# . . . . . . . & . #
# _ _ _ _ _ _ _ _ _ #
# # # # # # # # # # #