/ / / / _ _ _ _ _ _ _ _ _ _ _
/ / / / # # # # # # # # # # #
_ _ _ _ # . . b b b b . . . #
# # # # # . . b . # b b S . #
# . . . D b b b . # . . . . #
# . * . D . @ . . # . . . . #
# . . . D . . . . # . E . . #
# # # # # . . . . # . . . . #
/ / / / # _ _ _ _ _ _ _ _ _ #
/ / / / # # # # # # # # # # #
